5 5 5 5 5 5 5 5 5 5 5 5 5 5 5 0
4 4 4 4 4 4 4 4 4 4 4 4 4 4 4 4
3 3 3 6 3 3 3 3 3 3 3 3 3 3 3 3
2 2 2 2 2 6 2 2 2 2 2 2 2 2 2 2
7 8 1 1 1 1 1 1 1 6 6 1 1 1 1 1
0 0 0 0 0 0 0 0 0 0 0 0 0 0 0 0
0 0 0 0 0 0 0 0 0 0 0 0 0 0 0 0