5 5 5 5 5 5 6 5 5 5 5 5 5 5 5 5
4 4 4 4 4 4 4 4 4 4 6 4 4 4 4 4
3 3 3 6 3 3 3 3 3 3 3 3 3 3 3 3
2 2 2 2 2 6 2 2 2 2 2 2 2 2 2 2
1 1 1 1 7 1 1 1 1 1 8 1 1 1 1 1
0 0 0 0 0 0 0 0 0 0 0 0 0 0 0 0
0 0 0 0 0 0 0 0 0 0 0 0 0 0 0 0